1111111111111111111
1E00000000000000C11
10011000C000C000111
10000000C011C00C001
100000C0CCCCC000001
1P0000000000000C001
1111111111111111111